Xu, Xu, Xu, Xu, Xu, Xu, Xu, Xu, Xu, Xu, Xu, Xu, Xu, Xu, Xu, Xu, Xu, Xu, Xu, Xu, Xu, Xu, Xu, Xu, Xu, Xu, Xu, Xu, Xu, Xu
Xu, Xu, Xu, Xu, Xu, Xu, Xu, Xu, Xu, Xu, Xu, Xu, Xu, Xu, Xu, Xu, Xu, Xu, Xu, Xu, Xu, Xu, Xu, Xu, Xu, Xu, Xu, Xu, Xu, Xu
Xu, Xu, Xu, Xu, Xu, Xu, Xu, Xu, Xu, Xu, Xu, Xu, Xu, Xu, Xu, Xu, Xu, Xu, Xu, Xu, Xu, Xu, Xu, Xu, Xu, Xu, Xu, Xu, Xu, Xu
Uu, Xu, Uu, Xu, Xu, Xu, Xu, Xu, Xu, Xu, Xu, Xu, Xu, Xu, Xu, Xu, Xu, Xu, Xu, Xu, Xu, Xu, Xu, Xu, Xu, Xu, Xu, Xu, Xu, Xu
Uu, Uh, Uh, Uu, Uu, Xu, Xu, Xu, Xu, Xu, Xu, Xu, Xu, Xu, Xu, Xu, Xu, Xu, Xu, Xu, Xu, Xu, Xu, Xu, Xu, Xu, Xu, Xu, Xu, Xu
Uu, Uu, Uu, Uh, Co, Uu, Uu, Uh, Uu, Xu, Xu, Xu, Xu, Xu, Xu, Xu, Xu, Xu, Xu, Xu, Xu, Xu, Xu, Xu, Xu, Xu, Xu, Xu, Xu, Xu
Uu, Tb^Tf, Uu, Tb^Tf, 3 Ko, Uu^Vu, Uh, Uu, Tb^Tf, Uh, Uh, Xu, Xu, Xu, Xu, Xu, Xu, Xu, Xu, Xu, Xu, Xu, Xu, Xu, Xu, Xu, Xu, Xu, Xu, Xu
Uu, Tb^Tf, Tb^Tf, Co, Uu, Co, Uu, Uu, Uu, Uu, Uu, Uh, Uu, Xu, Xu, Xu, Xu, Xu, Xu, Xu, Xu, Xu, Xu, Xu, Xu, Xu, Xu, Xu, Tb^Tf, Uu
Uu, Uu, Uu^Vu, Uu, Tb^Tf, Tb^Tf, Uu, Uu, Uh, Uu, Uu, Uu, Uu, Uu, Tb^Tf, Xu, Uu, Xu, Xu, Xu, Xu, Xu, Xu, Xu, Xu, Xu, Uh, Uh, Tb^Tf, Uu
Xu, Xu, Xu, Uu, Tb^Tf, Tb^Tf, Uu, Uu, Uu, Uu^Vu, Uu, Uu, Uu^Vu, Uu, Uu, Uu, Uu, Uu, Uu, Uh, Uu, Xu, Xu, Xu, Uu, Uu^Vu, Co, Uu, Uu^Vu, Uu
Xu, Xu, Xu, Xu, Xu, Uh, Xu, Uu, Xu, Tb^Tf, Tb^Tf, Uu, Uu, Uu, Uh, Uu, Uh, Tb^Tf, Tb^Tf, Uu, Uu, Uu, Uu, Uu, Uu, Co, 2 Ko, Co, Uu, Uh
Xu, Xu, Xu, Xu, Xu, Xu, Xu, Xu, Xu, Xu, Uu, Uu, Uu, Uh, Uh, Uu, Uh, Tb^Tf, Uu, Uu, Uh, Uu, Uu, Uu, Uu, Uu, Uu, Co, Tb^Tf, Uh
Xu, Xu, Xu, Xu, Xu, Xu, Xu, Xu, Xu, Xu, Xu, Uu, Uu, Uu, Uu, Uu, Uu, Uu, Tb^Tf, Uh, Uh, Uh, Uu, Uh, Tb^Tf, Uu^Vu, Uh, Tb^Tf, Uh, Uu
Xu, Xu, Xu, Xu, Xu, Xu, Xu, Xu, Xu, Xu, Xu, Uh, Uu, Uu, Uu, Uu, Uh, Uu, Uu, Uh, Tb^Tf, Tb^Tf, Uu, Uu, Uu, Uu, Uu, Uu, Xu, Uu
Xu, Xu, Xu, Xu, Xu, Xu, Xu, Xu, Xu, Xu, Xu, Uh, Uu, Tb^Tf, Uu, Uu, Uu, Uu, Uu, Uu, Tb^Tf, Tb^Tf, Uh, Uu, Uu, Uu, Xu, Xu, Xu, Xu
Xu, Xu, Xu, Xu, Xu, Xu, Xu, Xu, Xu, Xu, Xu, Xu, Uh, Uh, Uu, Tb^Tf, Uu, Uh, Uu, Uu^Vu, Uu, Uh, Tb^Tf, Uu, Uu, Uh, Xu, Xu, Xu, Xu
Xu, Xu, Xu, Xu, Xu, Xu, Xu, Xu, Xu, Xu, Xu, Xu, Uu, Uu, Uu, Uu, Tb^Tf, Uu, Tb^Tf, Uu, Tb^Tf, Uu, Uu, Uu, Tb^Tf, Xu, Xu, Xu, Xu, Xu
Xu, Xu, Xu, Xu, Xu, Xu, Xu, Xu, Xu, Xu, Xu, Xu, Xu, Tb^Tf, Uu, Uu, Uu, Uh, Uh, Uu, Tb^Tf, Uu, Uh, Uu, Tb^Tf, Xu, Xu, Xu, Xu, Xu
Xu, Xu, Xu, Xu, Xu, Xu, Xu, Xu, Xu, Xu, Xu, Xu, Xu, Uu, Tb^Tf, Tb^Tf, Uu, Uh, Uu, Uu, Uu, Uu, Uu, Uu, Xu, Xu, Xu, Xu, Xu, Xu
Xu, Xu, Xu, Xu, Xu, Xu, Xu, Xu, Xu, Xu, Xu, Xu, Ur, Tb^Tf, Uu, Uu, Uu, Tb^Tf, Uu, Uu, Uu, Tb^Tf, Uu, Xu, Xu, Xu, Xu, Xu, Xu, Xu
Xu, Xu, Xu, Xu, Xu, Xu, Xu, Xu, Uh, Xu, Uh, Ur, Ur, Tb^Tf, Uu, Uu^Vu, Uu, Uu, Uh, Tb^Tf, Uu, Uu, Xu, Xu, Xu, Xu, Xu, Xu, Xu, Xu
Xu, Xu, Xu, Xu, Xu, Xu, Xu, Uu, Uu, Uu, Uh, Cud, Uu, Ur, Ur, Uu, Uh, Uh, Uu, Tb^Tf, Uh, Uh, Xu, Xu, Xu, Xu, Xu, Xu, Xu, Xu
Xu, Xu, Xu, Xu, Xu, Xu, Tb^Tf, Uh, Tb^Tf, Uu, Uu, Uu, Uu, Cud, Ur, Uu, Uh, Uu, Uu^Vu, Uu, Xu, Xu, Xu, Xu, Xu, Xu, Xu, Xu, Xu, Xu
Xu, Xu, Xu, Xu, Xu, Xu, Uu, Uu^Vud, Uu, Uh, Uu, Uu^Vud, Tb^Tf, Tb^Tf, Cud, Ur, Ur, Uu, Tb^Tf, Uu, Xu, Xu, Xu, Xu, Xu, Xu, Xu, Xu, Xu, Xu
Xu, Xu, Xu, Xu, Uu, Tb^Tf, Uu, Uh, Uu, Cud, 1 Kud, Cud, Uu, Tb^Tf, Uu, Uh, Xu, Xu, Xu, Xu, Xu, Xu, Xu, Xu, Xu, Xu, Xu, Xu, Xu, Xu
Xu, Xu, Xu, Xu, Uu, Uu^Vud, Uh, Uh, Ur, Ur, Cud, Uu, Uu, Uu^Vud, Uu, Uu, Xu, Xu, Xu, Xu, Xu, Xu, Xu, Xu, Xu, Xu, Xu, Xu, Xu, Xu
Xu, Xu, Tb^Tf, Uh, Ur, Ur, Ur, Ur, Uu, Uu, Uh, Uu, Uh, Uu, Uh, Uu, Xu, Xu, Xu, Xu, Xu, Xu, Xu, Xu, Xu, Xu, Xu, Xu, Xu, Xu
Uu, Uh, Uu, Ur, Uu, Tb^Tf, Uu, Uh, Tb^Tf, Uu^Vud, Uu, Tb^Tf, Uu, Uu, Tb^Tf, Xu, Xu, Xu, Xu, Xu, Xu, Xu, Xu, Xu, Xu, Xu, Xu, Xu, Xu, Xu
Uu, Uu, Ur, Ur, Uh, Uu, Tb^Tf, Uh, Uu, Tb^Tf, Xu, Uh, Xu, Uu^Vud, Xu, Xu, Xu, Xu, Xu, Xu, Xu, Xu, Xu, Xu, Xu, Xu, Xu, Xu, Xu, Xu
Uh, Ur, Ur, Uu, Xu, Xu, Xu, Xu, Xu, Xu, Xu, Xu, Xu, Xu, Xu, Xu, Xu, Xu, Xu, Xu, Xu, Xu, Xu, Xu, Xu, Xu, Xu, Xu, Xu, Xu
Uu^Uf, Ur, Uu, Xu, Xu, Xu, Xu, Xu, Xu, Xu, Xu, Xu, Xu, Xu, Xu, Xu, Xu, Xu, Xu, Xu, Xu, Xu, Xu, Xu, Xu, Xu, Xu, Xu, Xu, Xu
