border_size=1
usage=map

Xu          , Xu          , Xu          , Xu          , Xu          , Xu          , Xu          , Xu          , Xu          , Xu          , Xu          , Xu          , Xu          , Xu          , Uu          , Ur          , Uu^Uf       , Uu^Uf       , Uu^Uf       , Xu          , Xu          , Xu          , Xu          , Xu          , Xu          , Xu          , Xu          , Xu          , Xu          , Xu          , Xu          , Xu          
Xu          , Xu          , Xu          , Xu          , Xu          , Xu          , Xu          , Xu          , Xu          , Xu          , Xu          , Xu          , Uh          , Uu^Uf       , Ur          , 1 Ur        , Uu          , Uu^Uf       , Uu          , Xu          , Xu          , Xu          , Xu          , Xu          , Xu          , Xu          , Xu          , Xu          , Xu          , Xu          , Xu          , Xu          
Xu          , Xu          , Xu          , Xu          , Xu          , Xu          , Xu          , Xu          , Xu          , Xu          , Xu          , Xu          , Uh          , Ur          , Uu          , Uu          , Uu          , Uu          , Xu          , Xu          , Xu          , Xu          , Xu          , Xu          , Xu          , Xu          , Xu          , Xu          , Xu          , Xu          , Xu          , Xu          
Xu          , Xu          , Xu          , Xu          , Xu          , Xu          , Xu          , Xu          , Xu          , Xu          , Uu^Uf       , Uh          , Uu          , Uu          , Uu          , Uu          , Uh          , Uh          , Xu          , Xu          , Xu          , Xu          , Xu          , Xu          , Xu          , Xu          , Xu          , Xu          , Xu          , Xu          , Xu          , Xu          
Xu          , Xu          , Xu          , Xu          , Xu          , Xu          , Xu          , Xu          , Uu          , Uu^Uf       , Ur          , Ur          , Uu^Uf       , Uu^Uf       , Uu          , Uu          , Uh          , Xu          , Xu          , Xu          , Xu          , Xu          , Xu          , Xu          , Xu          , Xu          , Xu          , Xu          , Xu          , Xu          , Xu          , Xu          
Xu          , Xu          , Xu          , Xu          , Uu          , Uu^Uf       , Uu^Uf       , Uu^Uf       , Ur          , Ur          , Uu          , Uu          , Uu          , Uu          , Uu^Uf       , Uu          , Cud         , Xue         , Xue         , Xue         , Xue         , Xu          , Xu          , Xu          , Xu          , Xu          , Xu          , Xu          , Xu          , Xu          , Xu          , Xu          
Uu          , Uh          , Uh          , Uh          , Ur          , Uu          , Uu          , Ur          , Uu          , Uu          , Uh          , Uh          , Uh          , Uu^Uf       , Cud         , Cud         , Cud         , Uue         , Uue         , Uue         , Uue         , Xue         , Xue         , Xu          , Xu          , Xu          , Xu          , Xu          , Xu          , Xu          , Xu          , Xu          
Ur          , Uu          , Ur          , Ur          , Uh          , Uh          , Uh          , Uh          , Xu          , Uh          , Xu          , Xu          , Xue         , Cud         , Cud         , Cud         , Uue         , Uue         , Uue         , Qxe         , Qxe         , Uue         , Uue         , Xue         , Xue         , Xu          , Xu          , Xu          , Xu          , Xu          , Xu          , Xu          
Uh          , Uu          , Uu^Uf       , Uu^Uf       , Xu          , Xu          , Xu          , Xu          , Xu          , Xu          , Xue         , Xue         , Uue         , Uue         , Uue         , Uue         , Qxe         , Uue         , Uue^Vu      , Uue         , Uue         , Qxe         , Uue         , Uue         , Xue         , Xue         , Xu          , Xu          , Xu          , Xu          , Xu          , Xu          
Xu          , Uh          , Xu          , Xu          , Xu          , Xu          , Xu          , Xu          , Xu          , Xue         , Uue         , Uue         , Uue         , Uue         , Qxe         , Qxe         , Uue         , Uue         , Uue         , Uue         , Uue         , Uue         , Qxe         , Uue         , Uue         , Xue         , Xu          , Xu          , Xu          , Xu          , Xu          , Xu          
Xu          , Xu          , Xu          , Xu          , Xu          , Xu          , Xu          , Xu          , Xu          , Xue         , Uue         , Qxe         , Uue         , Uue         , Uue         , Uue         , Uue         , Uue         , Qxe         , Qxe         , Uue         , Uue         , Uue^Vu      , Qxe         , Uue         , Xue         , Xue         , Xu          , Xu          , Xu          , Xu          , Xu          
Xu          , Xu          , Xu          , Xu          , Xu          , Xu          , Xu          , Xu          , Xu          , Xue         , Uue         , Qxe         , Uue         , Uue         , Uue         , Uue         , Uue^Vu      , Uue         , Qxe         , Uue         , Uue         , Uue         , Qxe         , Qxe         , Uue         , Uue         , Xue         , Xue         , Xu          , Xu          , Xu          , Xu          
Xu          , Xu          , Xu          , Xu          , Xu          , Xu          , Xu          , Xu          , Xue         , Xue         , Uue^Uf      , Qxe         , Uue         , Qxe         , Uue         , Uue         , Uue         , Uue         , Qxe         , Qxe         , Uue         , Uue         , Qxe         , Uue         , Uue         , Uue^Uf      , Uue^Uf      , Xue         , Xue         , Xu          , Xu          , Xu          
Xu          , Xu          , Xu          , Xu          , Xu          , Xu          , Xu          , Xu          , Xue         , Uue^Uf      , Uue^Uf      , Uue         , Uue         , Qxe         , Uue^Uf      , Uue         , Uue         , Qxe         , Uue         , Uue         , Uue^Uf      , Uue         , Uue         , Uue         , Qxe         , Qxe         , Uue^Uf      , Xue         , Xue         , Xu          , Xu          , Xu          
Xu          , Xu          , Xu          , Xu          , Xu          , Xu          , Xu          , Xu          , Xu          , Xue         , Xue         , Uue^Vu      , Uue         , Qxe         , Uue^Uf      , Uue         , Uue         , Uue         , Uue         , Uue^Uf      , Qxe         , Uue         , Qxe         , Uue         , Qxe         , Qxe         , Uue         , Xue         , Xu          , Xu          , Xu          , Xu          
Xu          , Xu          , Xu          , Xu          , Xu          , Xu          , Xu          , Xu          , Xu          , Xu          , Xue         , Uue         , Uue         , Qxe         , Qxe         , Uue^Uf      , Uue^Uf      , Uue         , Uue         , Uue^Uf      , Qxe         , Qxe         , Uue         , Uue         , Uue         , Uue         , Xue         , Xue         , Xu          , Xu          , Xu          , Xu          
Xu          , Xu          , Xu          , Xu          , Xu          , Xu          , Xu          , Xu          , Xu          , Xu          , Xue         , Qxe         , Uue^Uf      , Uue         , Qxe         , Qxe         , Uue         , Uue         , Qxe         , Qxe         , Qxe         , Uue         , Uue         , 2 Uue^Vu    , Uue         , Uue         , Xue         , Xu          , Xu          , Xu          , Xu          , Xu          
Xu          , Xu          , Xu          , Xu          , Xu          , Xu          , Xu          , Xu          , Xu          , Xu          , Xue         , Qxe         , Qxe         , Uue         , Uue         , Uue         , Uue^Vu      , Uue         , Qxe         , Qxe         , Uue         , Uue         , Uue         , Uue         , Xue         , Xue         , Xu          , Xu          , Xu          , Xu          , Xu          , Xu          
Xu          , Xu          , Xu          , Xu          , Xu          , Xu          , Xu          , Xu          , Xu          , Xu          , Xu          , Xue         , Xue         , Uue         , Uue         , Uue         , Uue         , Uue         , Uue         , Uue         , Uue         , Uue         , Uue^Uf      , Xue         , Xu          , Xu          , Xu          , Xu          , Xu          , Xu          , Xu          , Xu          
Xu          , Xu          , Xu          , Xu          , Xu          , Xu          , Xu          , Xu          , Xu          , Xu          , Xu          , Xu          , Xu          , Xue         , Xue         , Qxe         , Qxe         , Uue         , Uue         , Uue^Uf      , Uue^Uf      , Uue^Uf      , Xue         , Xue         , Xu          , Xu          , Xu          , Xu          , Xu          , Xu          , Xu          , Xu          
Xu          , Xu          , Xu          , Xu          , Xu          , Xu          , Xu          , Xu          , Xu          , Xu          , Xu          , Xu          , Xu          , Xu          , Xu          , Xue         , Xue         , Xue         , Xue         , Xue         , Xue         , Xue         , Xu          , Xu          , Xu          , Xu          , Xu          , Xu          , Xu          , Xu          , Xu          , Xu          
Xu          , Xu          , Xu          , Xu          , Xu          , Xu          , Xu          , Xu          , Xu          , Xu          , Xu          , Xu          , Xu          , Xu          , Xu          , Xu          , Xu          , Xu          , Xu          , Xu          , Xu          , Xu          , Xu          , Xu          , Xu          , Xu          , Xu          , Xu          , Xu          , Xu          , Xu          , Xu          
Xu          , Xu          , Xu          , Xu          , Xu          , Xu          , Xu          , Xu          , Xu          , Xu          , Xu          , Xu          , Xu          , Xu          , Xu          , Xu          , Xu          , Xu          , Xu          , Xu          , Xu          , Xu          , Xu          , Xu          , Xu          , Xu          , Xu          , Xu          , Xu          , Xu          , Xu          , Xu          
Xu          , Xu          , Xu          , Xu          , Xu          , Xu          , Xu          , Xu          , Xu          , Xu          , Xu          , Xu          , Xu          , Xu          , Xu          , Xu          , Xu          , Xu          , Xu          , Xu          , Xu          , Xu          , Xu          , Xu          , Xu          , Xu          , Xu          , Xu          , Xu          , Xu          , Xu          , Xu          
Xu          , Xu          , Xu          , Xu          , Xu          , Xu          , Xu          , Xu          , Xu          , Xu          , Xu          , Xu          , Xu          , Xu          , Xu          , Xu          , Xu          , Xu          , Xu          , Xu          , Xu          , Xu          , Xu          , Xu          , Xu          , Xu          , Xu          , Xu          , Xu          , Xu          , Xu          , Xu          
Xu          , Xu          , Xu          , Xu          , Xu          , Xu          , Xu          , Xu          , Xu          , Xu          , Xu          , Xu          , Xu          , Xu          , Xu          , Xu          , Xu          , Xu          , Xu          , Xu          , Xu          , Xu          , Xu          , Xu          , Xu          , Xu          , Xu          , Xu          , Xu          , Xu          , Xu          , Xu          
Xu          , Xu          , Xu          , Xu          , Xu          , Xu          , Xu          , Xu          , Xu          , Xu          , Xu          , Xu          , Xu          , Xu          , Xu          , Xu          , Xu          , Xu          , Xu          , Xu          , Xu          , Xu          , Xu          , Xu          , Xu          , Xu          , Xu          , Xu          , Xu          , Xu          , Xu          , Xu          
Xu          , Xu          , Xu          , Xu          , Xu          , Xu          , Xu          , Xu          , Xu          , Xu          , Xu          , Xu          , Xu          , Xu          , Xu          , Xu          , Xu          , Xu          , Xu          , Xu          , Xu          , Xu          , Xu          , Xu          , Xu          , Xu          , Xu          , Xu          , Xu          , Xu          , Xu          , Xu          
Xu          , Xu          , Xu          , Xu          , Xu          , Xu          , Xu          , Xu          , Xu          , Xu          , Xu          , Xu          , Xu          , Xu          , Xu          , Xu          , Xu          , Xu          , Xu          , Xu          , Xu          , Xu          , Xu          , Xu          , Xu          , Xu          , Xu          , Xu          , Xu          , Xu          , Xu          , Xu          
Xu          , Xu          , Xu          , Xu          , Xu          , Xu          , Xu          , Xu          , Xu          , Xu          , Xu          , Xu          , Xu          , Xu          , Xu          , Xu          , Xu          , Xu          , Xu          , Xu          , Xu          , Xu          , Xu          , Xu          , Xu          , Xu          , Xu          , Xu          , Xu          , Xu          , Xu          , Xu          
