Xu, Xu, Xu, Xu, Xu, Xu, Xu, Xu, Xu, Xu, Tb^Tf, Uh, Tb^Tf, Uu, Uu, Uu, Uu, Cud, Ur
Xu, Xu, Xu, Xu, Xu, Xu, Xu, Xu, Xu, Xu, Uu, Uu^Vud, Uu, Uh, Uu, Uu^Vud, Tb^Tf, Tb^Tf, Cud
Xu, Xu, Xu, Xu, Xu, Xu, Xu, Xu, Uu, Tb^Tf, Uu, Uh, Uu, Cud, 3 Kud, Cud, Uu, Tb^Tf, Uu
Xu, Xu, Xu, Xu, Xu, Xu, Uu, Uu, Uu, Uu^Vud, Uh, Uh, Ur, Ur, Cud, Uu, Uu, Uu^Vud, Uu
Xu, Xu, Xu, Xu, Xu, Xu, Uu, Uu, Ur, Ur, Ur, Ur, Uu, Uu, Uh, Uu, Uh, Uu, Uh
Xu, Xu, Xu, Xu, Uu, Cud, Ur, Uu, Uu, Tb^Tf, Uu, Uh, Tb^Tf, Uu^Vud, Uu, Tb^Tf, Uu, Uu, Tb^Tf
Xu, Xu, Xu, Xu, Uu, Ur, Cud, Cud, Xu, Uu, Tb^Tf, Uh, Uu, Tb^Tf, Xos, Uh, Xu, Uu^Vud, Xu
Xu, Xu, Xu, Xu, Uu, Ur, Cud, Xu, Xu, Xu, Xu, Xu, Xu, Xos, Re, Xos, Xos, Xu, Xu
Xu, Xu, Xu, Xu, Cud, Uu, Uu, Xu, Xu, Xu, Xu, Xu, Xos, Xos, Uue, Tb^Tf, Xos, Xu, Xu
Xu, Xu, Xu, Xu, Cud, Uu, Ur, Uu, Uu, Xu, Xu, Xu, Xos, Uue^Vud, Uue, Xos, Xu, Xu, Xu
Xu, Xu, Xu, Xu, Qxu, Cud, Uu, Ur, Uu, Uu^Vu, Qxu, Xu, Xos, Uue, Xos, Xos, Xu, Xu, Xu
Xu, Xu, Xu, Xu, Xu, Qxu, Qxu, Uu, Ur, Uu, Uh, Qxu, Qxe^Bs/, Uue, Xos, Xu, Xu, Xu, Xu
Xu, Xu, Xu, Xu, Xu, Xu, Xu, Uu^Vu, Uu, Ur, Uu, Uh, Qxu, Qxe, Xu, Xu, Xu, Xu, Xu
Xu, Xu, Xu, Xu, Xu, Xu, Xu, Qxu, Qxu, Uu, Ur, Uh, Qxu, Qxu, Qxu, Xu, Xu, Xu, Xu
Xu, Xu, Xu, Xu, Xu, Xu, Xu, Xu, Xu, Uu, Ur, Uu, Uh, Qxu, Qxu, Xu, Xu, Xu, Xu
Xu, Xu, Xu, Xu, Xu, Xu, Xu, Xu, Cud, Uu, Uu, Uu, Cud, Qxu, Qxu, Xu, Xu, Xu, Xu
Xu, Xu, Xu, Xu, Xu, Xu, Xu, Xu, Cud, Cud, Uu, Cud, Cud, Qxu, Qxu, Xu, Xu, Xu, Xu
Xu, Xu, Xu, Xu, Xu, Xu, Xu, Xu, Uu, Uu, Ur, Uu, Uu, Qxu, Xu, Xu, Xu, Xu, Xu
Xu, Xu, Xu, Xu, Xu, Xu, Xu, Xu, Uu^Vu, Ur, Uu, Uu^Vu, Uu, Qxu, Xu, Xu, Xu, Xu, Xu
Xu, Xu, Xu, Xu, Xu, Xu, Xu, Xu, Tb^Tf, Ur, Uu, Uu, Uu, Tb^Tf, Xu, Xu, Xu, Xu, Xu
Xu, Xu, Xu, Xu, Xu, Xu, Uu, Uu, Uu, Uu, Tb^Tf, Uu, Uu^Vu, Uu, Xu, Xu, Xu, Xu, Xu
Xu, Xu, Xu, Xu, Xu, Uu, Uu, Tb^Tf, Ur, Uh, Uu, Uu, Uu, Uu, Xu, Xu, Xu, Xu, Xu
Xu, Xu, Xu, Xu, Ur^Vct, Tb^Tf, Uu, Ur^Vct, Ur, Ur^Vct, Uu, Uu, Xu, Xu, Xu, Xu, Xu, Xu, Xu
Xu, Xu, Uu, Uu, Uh, Uh, Ur^Vct, Ur, Tb^Tf, Uu, Uu, Xu, Xu, Xu, Xu, Xu, Xu, Xu, Xu
Uu, Uu, 2 Ke, Ce, Tb^Tf, Tb^Tf, 1 Ke, Uu, Uu, Uu, Uu, Xu, Xu, Xu, Xu, Xu, Xu, Xu, Xu
Uu, Ce, Ce, Ce, Uu, Ce, Ce, Ce, Uu, Ur^Vct, Xu, Xu, Xu, Xu, Xu, Xu, Xu, Xu, Xu
Tb^Tf, Uu, Uu, Re^Vct, Ur, Ur, Uu, Tb^Tf, Xu, Xu, Xu, Xu, Xu, Xu, Xu, Xu, Xu, Xu, Xu
Uu, Uh, Tb^Tf, Ur, Uu, Uu, Uu, Tb^Tf, Xu, Xu, Xu, Xu, Xu, Xu, Xu, Xu, Xu, Xu, Xu
