border_size=1
usage=map

Xu          , Xu          , Xu          , Xu          , Xu          , Xu          , Xu          , Xu          , Xu          , Xu          , Uu^Uf       , Uh          , Uu^Uf       , Uu          , Uu          , Uu          , Uu          , Cud         , Ur          
Xu          , Xu          , Xu          , Xu          , Xu          , Xu          , Xu          , Xu          , Xu          , Xu          , Uu          , Uu^Vud      , Uu          , Uh          , Uu          , Uu^Vud      , Uu^Uf       , Uu^Uf       , Cud         
Xu          , Xu          , Xu          , Xu          , Xu          , Xu          , Xu          , Xu          , Uu          , Uu^Uf       , Uu          , Uh          , Uu          , Cud         , 3 Kud       , Cud         , Uu          , Uu^Uf       , Uu          
Xu          , Xu          , Xu          , Xu          , Xu          , Xu          , Uu          , Uu          , Uu          , Uu^Vud      , Uh          , Uh          , Ur          , Ur          , Cud         , Uu          , Uu          , Uu^Vud      , Uu          
Xu          , Xu          , Xu          , Xu          , Xu          , Xu          , Uu          , Uu          , Ur          , Ur          , Ur          , Ur          , Uu          , Uu          , Uh          , Uu          , Uh          , Uu          , Uh          
Xu          , Xu          , Xu          , Xu          , Uu          , Cud         , Ur          , Uu          , Uu          , Uu^Uf       , Uu          , Uh          , Uu^Uf       , Uu^Vud      , Uu          , Uu^Uf       , Uu          , Uu          , Uu^Uf       
Xu          , Xu          , Xu          , Xu          , Uu          , Ur          , Cud         , Cud         , Xu          , Uu          , Uu^Uf       , Uh          , Uu          , Uu^Uf       , Xuce        , Uh          , Xu          , Uu^Vud      , Xu          
Xu          , Xu          , Xu          , Xu          , Uu          , Ur          , Cud         , Xu          , Xu          , Xu          , Xu          , Xu          , Xu          , Xuce        , Re          , Xuce        , Xuce        , Xu          , Xu          
Xu          , Xu          , Xu          , Xu          , Cud         , Uu          , Uu          , Xu          , Xu          , Xu          , Xu          , Xu          , Xuce        , Xuce        , Uue         , Uue^Uf      , Xuce        , Xu          , Xu          
Xu          , Xu          , Xu          , Xu          , Cud         , Uu          , Ur          , Uu          , Uu          , Xu          , Xu          , Xu          , Xuce        , Uue^Vud     , Uue         , Xuce        , Xu          , Xu          , Xu          
Xu          , Xu          , Xu          , Xu          , Qxu         , Cud         , Uu          , Ur          , Uu          , Uu^Vu       , Qxu         , Xu          , Xuce        , Uue         , Xuce        , Xuce        , Xu          , Xu          , Xu          
Xu          , Xu          , Xu          , Xu          , Xu          , Qxu         , Qxu         , Uu          , Ur          , Uu          , Uh          , Qxu         , Qxe^Bs/     , Uue         , Xuce        , Xu          , Xu          , Xu          , Xu          
Xu          , Xu          , Xu          , Xu          , Xu          , Xu          , Xu          , Uu^Vu       , Uu          , Ur          , Uu          , Uh          , Qxu         , Qxe         , Xu          , Xu          , Xu          , Xu          , Xu          
Xu          , Xu          , Xu          , Xu          , Xu          , Xu          , Xu          , Qxu         , Qxu         , Uu          , Ur          , Uh          , Qxu         , Qxu         , Qxu         , Xu          , Xu          , Xu          , Xu          
Xu          , Xu          , Xu          , Xu          , Xu          , Xu          , Xu          , Xu          , Xu          , Uu          , Ur          , Uu          , Uh          , Qxu         , Qxu         , Xu          , Xu          , Xu          , Xu          
Xu          , Xu          , Xu          , Xu          , Xu          , Xu          , Xu          , Xu          , Cud         , Uu          , Uu          , Uu          , Cud         , Qxu         , Qxu         , Xu          , Xu          , Xu          , Xu          
Xu          , Xu          , Xu          , Xu          , Xu          , Xu          , Xu          , Xu          , Cud         , Cud         , Uu          , Cud         , Cud         , Qxu         , Qxu         , Xu          , Xu          , Xu          , Xu          
Xu          , Xu          , Xu          , Xu          , Xu          , Xu          , Xu          , Xu          , Uu          , Uu          , Ur          , Uu          , Uu          , Qxu         , Xu          , Xu          , Xu          , Xu          , Xu          
Xu          , Xu          , Xu          , Xu          , Xu          , Xu          , Xu          , Xu          , Uu^Vu       , Ur          , Uu          , Uu^Vu       , Uu          , Qxu         , Xu          , Xu          , Xu          , Xu          , Xu          
Xu          , Xu          , Xu          , Xu          , Xu          , Xu          , Xu          , Xu          , Uu^Uf       , Ur          , Uu          , Uu          , Uu          , Uu^Uf       , Xu          , Xu          , Xu          , Xu          , Xu          
Xu          , Xu          , Xu          , Xu          , Xu          , Xu          , Uu          , Uu          , Uu          , Uu          , Uu^Uf       , Uu          , Uu^Vu       , Uu          , Xu          , Xu          , Xu          , Xu          , Xu          
Xu          , Xu          , Xu          , Xu          , Xu          , Uu          , Uu          , Uu^Uf       , Ur          , Uh          , Uu          , Uu          , Uu          , Uu          , Xu          , Xu          , Xu          , Xu          , Xu          
Xu          , Xu          , Xu          , Xu          , Ur^Vct      , Ur^Uf       , Uu          , Ur^Vct      , Ur          , Ur^Vct      , Uu          , Uu          , Xu          , Xu          , Xu          , Xu          , Xu          , Xu          , Xu          
Xu          , Xu          , Uu          , Uu          , Uh          , Uh          , Ur^Vct      , Ur          , Uu^Uf       , Uu          , Uu          , Xu          , Xu          , Xu          , Xu          , Xu          , Xu          , Xu          , Xu          
Uu          , Uu          , 2 Ke        , Ce          , Uu^Uf       , Uu^Uf       , 1 Ke        , Uu          , Uu          , Uu          , Uu          , Xu          , Xu          , Xu          , Xu          , Xu          , Xu          , Xu          , Xu          
Uu          , Ce          , Ce          , Ce          , Uu          , Ce          , Ce          , Ce          , Uu          , Ur^Vct      , Xu          , Xu          , Xu          , Xu          , Xu          , Xu          , Xu          , Xu          , Xu          
Uu^Uf       , Uu          , Uu          , Re^Vct      , Ur          , Ur          , Uu          , Uu^Uf       , Xu          , Xu          , Xu          , Xu          , Xu          , Xu          , Xu          , Xu          , Xu          , Xu          , Xu          
Uu          , Uh          , Uu^Uf       , Ur          , Uu          , Uu          , Uu          , Uu^Uf       , Xu          , Xu          , Xu          , Xu          , Xu          , Xu          , Xu          , Xu          , Xu          , Xu          , Xu          
