Xu, Xu, Xu, Xu, Xu, Xu, Xu, Xu, Xu, Xu, Xu, Xu, Xu, Xu, Xu, Xu, Xu, Xu, Xu, Xu, Xu, Xu, Xu, Xu, Xu, Xu, Xu, Xu, Xu, Xu, Xu, Xu
Xu, Xu, Xu, Xu, Xu, Xu, Xu, Xu, Xu, Xu, Xu, Xu, Xu, Xu, Xu, Xu, Xu, Xu, Xu, Xu, Xu, Xu, Xu, Xu, Xu, Xu, Xu, Xu, Xu, Xu, Xu, Xu
Tb^Tf, Xu, Xu, Xu, Xu, Xu, Xu, Xu, Xu, Xu, Xu, Xu, Xu, Xu, Xu, Xu, Xu, Xu, Xu, Xu, Xu, Xu, Xu, Xu, Xu, Xu, Xu, Xu, Xu, Xu, Xu, Xu
Rb, Tb^Tf, Uu, Xu, Uu, Xu, Xu, Xu, Xu, Xu, Xu, Xu, Xu, Xu, Xu, Xu, Xu, Xu, Xu, Xu, Xu, Xu, Xu, Xu, Xu, Xu, Xu, Xu, Xu, Xu, Xu, Xu
Uh, Uh, Uu, Uh, Uh, Uu, Uu, Xu, Xu, Xu, Xu, Xu, Xu, Xu, Xu, Xu, Xu, Xu, Xu, Xu, Xu, Xu, Xu, Xu, Xu, Xu, Xu, Xu, Xu, Xu, Xu, Xu
Uu, Uh, Uu, Uu, Uu, Uh, Co, Uu, Uu, Uh, Uu, Xu, Xu, Xu, Xu, Xu, Xu, Xu, Xu, Xu, Xu, Xu, Xu, Xu, Xu, Xu, Xu, Xu, Xu, Xu, Xu, Xu
Tb^Tf, Uu, Uu, Tb^Tf, Uu, Tb^Tf, 3 Ko, Uu^Vu, Uh, Uu, Tb^Tf, Uh, Uh, Xu, Xu, Xu, Xu, Xu, Xu, Xu, Xu, Xu, Xu, Xu, Xu, Xu, Xu, Xu, Xu, Xu, Xu, Xu
Tb^Tf, Uh, Uu, Tb^Tf, Tb^Tf, Co, Uu^Vu, Co, Uu, Uu, Uu, Uu, Uu, Uh, Uu, Xu, Xu, Xu, Xu, Xu, Xu, Xu, Xu, Xu, Xu, Xu, Xu, Xu, Xu, Xu, Tb^Tf, Uu
Xu, Uh, Uh, Uu, Uu^Vu, Uu, Tb^Tf, Tb^Tf, Uu, Uu, Uh, Uu, Uu, Uu, 4 Ko, Uu, Tb^Tf, Xu, Uu, Xu, Xu, Xu, Xu, Xu, Xu, Xu, Xu, Xu, Uh, Uh, Tb^Tf, Uu
Xu, Xu, Xu, Xu, Xu, Uu, Tb^Tf, Tb^Tf, Uu, Uu, Uu, Uu^Vu, Uu, Co, Co^Vu, Co, Uu, Uu, Uu, Uu, Uu, Uh, 7 Ko, Xu, Xu, Xu, Uu, Uu^Vu, Co, Uu, Uu^Vu, Uu
Xu, Xu, Xu, Xu, Xue, Xue, Xue, Uh, Xu, Uu, Xu, Tb^Tf, Tb^Tf, Co, Co, Co, Uh, Uu, Uh, Tb^Tf, Tb^Tf, Co, Co, Co, Uu, Uu, Uu, Co, 2 Ko, Co, Uu, Uh
Xu, Xu, Xu, Xue, Qxe, Qxe, Uue, Xue, Xue, Xu, Xu, Xu, Uu, Uu, Uu, Uh, Uh, Uu, Uh, Tb^Tf, Uu, Co, Uh, Co, Uu, Uu, Uu, Uu, Uu, Co, Tb^Tf, Uh
Xu, Xu, Xu, Xue, Qxe, Uue, Tb^Tf, Qxe, Xue, Xu, Xu, Xu, Xu, Uu, Uu, Uu, Co, Uu, Uu, Uu, Tb^Tf, Uh, Uh, Uh, Uu, Uh, Tb^Tf, Uu^Vu, Uh, Tb^Tf, Uh, Uu
Xu, Xu, Xu, Xue, Qxe, Uue, Uue, Qxe, Qxe, Xue, Xue, Xu, Xu, Uh, Uu, Co, Co^Vu, 5 Ko, Uh, Uu, Uu, Uh, Tb^Tf, Tb^Tf, Uu, Uu, Uu, Uu, Uu, Uu, Xu, Uu
Xu, Xu, Xu, Xue, Xue, Qxe, Uue, Xue, Xue, Qxe, Xue, Xu, Xu, Uh, Uu, Tb^Tf, Co, Co, Uu, Uu, 6 Ko, Co, Tb^Tf, Tb^Tf, Uh, Uu, Uu, Uu, Xu, Xu, Xu, Xu
Xu, Xu, Xu, Xu, Xue, Qxe, Uue, Uue, Qxe, Qxe, Xue, Xu, Xu, Xu, Uh, Uh, Uu, Tb^Tf, Uu, Uh, Co, Co^Vu, Co, Uh, Tb^Tf, Uu, Uu, Uh, Xu, Xu, Xu, Xu
Xu, Xu, Xu, Xue, Qxe, Qxe, Xue, Uue, Qxe, Xue, Xu, Xu, Xu, Xu, Uu, Uu, Uu, Uu, Tb^Tf, Uu, Tb^Tf, Co, Tb^Tf, Uu, Uu, Uu, Tb^Tf, Xu, Xu, Xu, Xu, Xu
Xu, Xu, Xu, Xue, Qxe, Xue, Tb^Tf, Uue, Uue, Xue, Xue, Xu, Xu, Xu, Xu, Tb^Tf, Uu, Uu, Uu, Uh, Uh, Uu, Tb^Tf, Uu, Uh, Uu, Tb^Tf, Xu, Xu, Xu, Xu, Xu
Xu, Xu, Xu, Xue, Qxe, Xue, Qxe, Tb^Tf, Uue, Qxe, Xue, Xu, Xu, Xu, Xu, Uu, Tb^Tf, Tb^Tf, Uu, Uh, Uu, Uu, Uu, Uu, Uu, Uu, Xue, Xu, Xue, Xu, Xu, Xu
Xu, Xu, Xu, Xue, Xue, Qxe, Xue, Xue, Uue, Uue, Xue, Xu, Xu, Xu, Rb, Tb^Tf, Uu, Uu, Uu, Tb^Tf, Uu, Uu, Uu, Tb^Tf, Uu, Xue, Uue, Xue, Qxe, Xue, Xue, Xu
Xu, Xu, Xu, Xu, Xu, Xue, Xu, Xue, Xue, Xu, Uh, Xu, Cud, Rb, Rb, Tb^Tf, Uu, Uu^Vu, Uu, Uu, Uh, Tb^Tf, Uu, Uu, Xue, Xue, Tb^Tf, Uue, Tb^Tf, Qxe, Xue, Xu
Xu, Xu, Xu, Xu, Xu, Xu, Xu, Xu, Xu, Uu, Uu, Uu, Uh, Cud, Cud, Rb, Rb, Uu, Uh, Uh, Uu, Tb^Tf, Uh, Uh, Xue, Qxe, Qxe, Uue, Tb^Tf, Qxe, Xue, Xu
Xu, Xu, Xu, Xu, Xu, Xu, Xu, Xu, Tb^Tf, Uh, Tb^Tf, Uu, Uu, Uu, Uu, Cud, Rb, Uu, Uh, Uu, Uu^Vu, Uu, Xu, Xu, Xu, Xue, Qxe, Uue, Uue, Xue, Xue, Xu
Xu, Xu, Xu, Xu, Xu, Xu, Xu, Xu, Uu, Uu^Vud, Uu, Uh, Uu, Uu^Vud, Tb^Tf, Cud, Cud, Rb, Rb, Uu, Tb^Tf, Uu, Xu, Xu, Xue, Xue, Uue, Uue, Uue, Qxe, Xue, Xu
Xu, Xu, Xu, Xu, Xu, Xu, Uu, Tb^Tf, Cud, Uh, Uu, Cud, 1 Kud, Cud, Uu, Tb^Tf, Cud, Rb, Xu, Xu, Xue, Xu, Xue, Xue, Qxe, Qxe, Tb^Tf, Tb^Tf, Qxe, Qxe, Xue, Xu
Xu, Xu, Xu, Xu, Xu, Xu, Uu, Uu^Vud, Uh, Uh, Ur, Ur, Cud, Uu, Uu, Uu^Vud, Uu, Cud, Xue, Xue, Qxe, Xue, Qxe, Xue, Tb^Tf, Uue, Xue, Tb^Tf, Qxe, Xue, Xu, Xu
Xu, Xu, Xu, Xu, Uu, Uu, Ur, Ur, Ur, Cud, Uu, Uu, Uh, Uu, Uh, Uu, Uh, Uu, Xue, Qxe, Uue, Qxe, Uue, Tb^Tf, Uue, Uue, Xue, Uue, Qxe, Xue, Xu, Xu
Xu, Xu, Uu, Cud, Ur, Uu, Uu, Tb^Tf, Uu, Uh, Tb^Tf, Cud, Uu, Tb^Tf, Uu, Uu, Tb^Tf, Xue, Uue, Uue, Tb^Tf, Uue, Uue, Tb^Tf, Xue, Qxe, Tb^Tf, Uue, Xue, Xue, Xu, Xu
Xu, Xu, Uu, Ur, Cud, Cud, Uh, Uu, Tb^Tf, Uh, Uu, Tb^Tf, Xue, Uh, Xu, Uu^Vud, Xu, Xue, Qxe, Tb^Tf, Qxe, Uue, Qxe, Qxe, Xue, Qxe, Qxe, Qxe, Xue, Xu, Xu, Xu
Xu, Xu, Uu, Ur, Cud, Xu, Xu, Xu, Xu, Xu, Xu, Xoc, Rb, Xue, Xoc, Xu, Xu, Xue, Xue, Qxe, Xue, Xue, Xue, Xue, Xu, Xue, Xue, Xue, Xu, Xu, Xu, Xu
Xu, Xu, Cud, Uu, Uu, Xu, Xu, Xu, Xu, Xu, Xoc, Xoc, Uue, Tb^Tf, Xoc, Xu, Xu, Xu, Xu, Xue, Xu, Xu, Xu, Xu, Xu, Xu, Xu, Xu, Xu, Xu, Xu, Xu
Xu, Xu, Cud, Uu, Ur, Uu, Uu, Xu, Xu, Xu, Xoc, Uue^Vud, Uue, Xoc, Xu, Xu, Xu, Xu, Xu, Xu, Xu, Xu, Xu, Xu, Xu, Xu, Xu, Xu, Xu, Xu, Xu, Xu
Xu, Xu, Qxu, Cud, Uu, Ur, Uu, Uu^Vu, Qxu, Xu, Xoc, Uue, Xoc, Xoc, Xu, Xu, Xu, Xu, Xu, Xu, Xu, Xu, Xu, Xu, Xu, Xu, Xu, Xu, Xu, Xu, Xu, Xu
Xu, Xu, Xu, Qxu, Qxu, Uu, Ur, Uu, Uh, Qxu, Qxe^Bs/, Uue, Xoc, Xu, Xu, Xu, Xu, Xu, Xu, Xu, Xu, Xu, Xu, Xu, Xu, Xu, Xu, Xu, Xu, Xu, Xu, Xu
Xu, Xu, Xu, Xu, Xu, Uu^Vu, Uu, Ur, Uu, Uh, Qxu, Qxe, Xu, Xu, Xu, Xu, Xu, Xu, Xu, Xu, Xu, Xu, Xu, Xu, Xu, Xu, Xu, Xu, Xu, Xu, Xu, Xu
Xu, Xu, Xu, Xu, Xu, Qxu, Qxu, Uu, Ur, Uh, Qxu, Qxu, Qxu, Xu, Xu, Xu, Xu, Xu, Xu, Xu, Xu, Xu, Xu, Xu, Xu, Xu, Xu, Xu, Xu, Xu, Xu, Xu
Xu, Xu, Xu, Xu, Xu, Xu, Xu, Uu, Ur, Uu, Uh, Qxu, Qxu, Xu, Xu, Xu, Xu, Xu, Xu, Xu, Xu, Xu, Xu, Xu, Xu, Xu, Xu, Xu, Xu, Xu, Xu, Xu
Xu, Xu, Xu, Xu, Xu, Xu, Cud, Uu, Uu, Uu, Cud, Qxu, Qxu, Xu, Xu, Xu, Xu, Xu, Xu, Xu, Xu, Xu, Xu, Xu, Xu, Xu, Xu, Xu, Xu, Xu, Xu, Xu
Xu, Xu, Xu, Xu, Xu, Xu, Cud, Cud, Uu, Cud, Cud, Qxu, Qxu, Xu, Xu, Xu, Xu, Xu, Xu, Xu, Xu, Xu, Xu, Xu, Xu, Xu, Xu, Xu, Xu, Xu, Xu, Xu
Xu, Xu, Xu, Xu, Xu, Xu, Uu, Uu, Ur, Uu, Uu, Qxu, Xu, Xu, Xu, Xu, Xu, Xu, Xu, Xu, Xu, Xu, Xu, Xu, Xu, Xu, Xu, Xu, Xu, Xu, Xu, Xu
