border_size=1
usage=map

Xu          , Xu          , Xu          , Xu          , Xu          , Xu          , Xu          , Xu          , Xu          , Xu          , Xu          , Xu          , Xu          , Xu          , Xu          , Xu          , Xu          , Xu          , Xu          , Xu          , Xu          , Xu          , Xu          , Xu          , Xu          , Xu          , Xu          , Xu          , Xu          , Xu          , Xu          , Xu          
Xu          , Xu          , Xu          , Xu          , Xu          , Xu          , Xu          , Xu          , Xu          , Xu          , Xu          , Xu          , Xu          , Xu          , Xu          , Xu          , Xu          , Xu          , Xu          , Xu          , Xu          , Xu          , Xu          , Xu          , Xu          , Xu          , Xu          , Xu          , Xu          , Xu          , Xu          , Xu          
Uu^Uf       , Xu          , Xu          , Xu          , Xu          , Xu          , Xu          , Xu          , Xu          , Xu          , Xu          , Xu          , Xu          , Xu          , Xu          , Xu          , Xu          , Xu          , Xu          , Xu          , Xu          , Xu          , Xu          , Xu          , Xu          , Xu          , Xu          , Xu          , Xu          , Xu          , Xu          , Xu          
Rb          , Uu^Uf       , Uu          , Xu          , Uu          , Xu          , Xu          , Xu          , Xu          , Xu          , Xu          , Xu          , Xu          , Xu          , Xu          , Xu          , Xu          , Xu          , Xu          , Xu          , Xu          , Xu          , Xu          , Xu          , Xu          , Xu          , Xu          , Xu          , Xu          , Xu          , Xu          , Xu          
Uh          , Uh          , Uu          , Uh          , Uh          , Uu          , Uu          , Xu          , Xu          , Xu          , Xu          , Xu          , Xu          , Xu          , Xu          , Xu          , Xu          , Xu          , Xu          , Xu          , Xu          , Xu          , Xu          , Xu          , Xu          , Xu          , Xu          , Xu          , Xu          , Xu          , Xu          , Xu          
Uu          , Uh          , Uu          , Uu          , Uu          , Uh          , Co          , Uu          , Uu          , Uh          , Uu          , Xu          , Xu          , Xu          , Xu          , Xu          , Xu          , Xu          , Xu          , Xu          , Xu          , Xu          , Xu          , Xu          , Xu          , Xu          , Xu          , Xu          , Xu          , Xu          , Xu          , Xu          
Uu^Uf       , Uu          , Uu          , Uu^Uf       , Uu          , Uu^Uf       , 3 Ko        , Uu^Vu       , Uh          , Uu          , Uu^Uf       , Uh          , Uh          , Xu          , Xu          , Xu          , Xu          , Xu          , Xu          , Xu          , Xu          , Xu          , Xu          , Xu          , Xu          , Xu          , Xu          , Xu          , Xu          , Xu          , Xu          , Xu          
Uu^Uf       , Uh          , Uu          , Uu^Uf       , Uu^Uf       , Co          , Uu^Vu       , Co          , Uu          , Uu          , Uu          , Uu          , Uu          , Uh          , Uu          , Xu          , Xu          , Xu          , Xu          , Xu          , Xu          , Xu          , Xu          , Xu          , Xu          , Xu          , Xu          , Xu          , Xu          , Xu          , Uu^Uf       , Uu          
Xu          , Uh          , Uh          , Uu          , Uu^Vu       , Uu          , Uu^Uf       , Uu^Uf       , Uu          , Uu          , Uh          , Uu          , Uu          , Uu          , 4 Ko        , Uu          , Uu^Uf       , Xu          , Uu          , Xu          , Xu          , Xu          , Xu          , Xu          , Xu          , Xu          , Xu          , Xu          , Uh          , Uh          , Uu^Uf       , Uu          
Xu          , Xu          , Xu          , Xu          , Xu          , Uu          , Uu^Uf       , Uu^Uf       , Uu          , Uu          , Uu          , Uu^Vu       , Uu          , Co          , Co^Vu       , Co          , Uu          , Uu          , Uu          , Uu          , Uu          , Uh          , 7 Ko        , Xu          , Xu          , Xu          , Uu          , Uu^Vu       , Co          , Uu          , Uu^Vu       , Uu          
Xu          , Xu          , Xu          , Xu          , Xuce        , Xue         , Xue         , Uh          , Xu          , Uu          , Xu          , Uu^Uf       , Uu^Uf       , Co          , Co          , Co          , Uh          , Uu          , Uh          , Uu^Uf       , Uu^Uf       , Co          , Co          , Co          , Uu          , Uu          , Uu          , Co          , 2 Ko        , Co          , Uu          , Uh          
Xu          , Xu          , Xu          , Xuce        , Qxe         , Qxe         , Uue         , Xue         , Xue         , Xu          , Xu          , Xu          , Uu          , Uu          , Uu          , Uh          , Uh          , Uu          , Uh          , Uu^Uf       , Uu          , Co          , Uh          , Co          , Uu          , Uu          , Uu          , Uu          , Uu          , Co          , Uu^Uf       , Uh          
Xu          , Xu          , Xu          , Xuce        , Qxe         , Uue         , Uue^Uf      , Qxe         , Xue         , Xu          , Xu          , Xu          , Xu          , Uu          , Uu          , Uu          , Co          , Uu          , Uu          , Uu          , Uu^Uf       , Uh          , Uh          , Uh          , Uu          , Uh          , Uu^Uf       , Uu^Vu       , Uh          , Uu^Uf       , Uh          , Uu          
Xu          , Xu          , Xu          , Xuce        , Qxe         , Uue         , Uue         , Qxe         , Qxe         , Xuce        , Xuce        , Xu          , Xu          , Uh          , Uu          , Co          , Co^Vu       , 5 Ko        , Uh          , Uu          , Uu          , Uh          , Uu^Uf       , Uu^Uf       , Uu          , Uu          , Uu          , Uu          , Uu          , Uu          , Xu          , Uu          
Xu          , Xu          , Xu          , Xuce        , Xue         , Qxe         , Uue         , Xue         , Xue         , Qxe         , Xuce        , Xu          , Xu          , Uh          , Uu          , Uu^Uf       , Co          , Co          , Uu          , Uu          , 6 Ko        , Co          , Uu^Uf       , Uu^Uf       , Uh          , Uu          , Uu          , Uu          , Xu          , Xu          , Xu          , Xu          
Xu          , Xu          , Xu          , Xu          , Xuce        , Qxe         , Uue         , Uue         , Qxe         , Qxe         , Xuce        , Xu          , Xu          , Xu          , Uh          , Uh          , Uu          , Uu^Uf       , Uu          , Uh          , Co          , Co^Vu       , Co          , Uh          , Uu^Uf       , Uu          , Uu          , Uh          , Xu          , Xu          , Xu          , Xu          
Xu          , Xu          , Xu          , Xuce        , Qxe         , Qxe         , Xue         , Uue         , Qxe         , Xue         , Xu          , Xu          , Xu          , Xu          , Uu          , Uu          , Uu          , Uu          , Uu^Uf       , Uu          , Uu^Uf       , Co          , Uu^Uf       , Uu          , Uu          , Uu          , Uu^Uf       , Xu          , Xu          , Xu          , Xu          , Xu          
Xu          , Xu          , Xu          , Xuce        , Qxe         , Xue         , Uue^Uf      , Uue         , Uue         , Xue         , Xue         , Xu          , Xu          , Xu          , Xu          , Uu^Uf       , Uu          , Uu          , Uu          , Uh          , Uh          , Uu          , Uu^Uf       , Uu          , Uh          , Uu          , Uu^Uf       , Xu          , Xu          , Xu          , Xu          , Xu          
Xu          , Xu          , Xu          , Xuce        , Qxe         , Xue         , Qxe         , Uue^Uf      , Uue         , Qxe         , Xue         , Xu          , Xu          , Xu          , Xu          , Uu          , Uu^Uf       , Uu^Uf       , Uu          , Uh          , Uu          , Uu          , Uu          , Uu          , Uu          , Uu          , Xue         , Xu          , Xue         , Xu          , Xu          , Xu          
Xu          , Xu          , Xu          , Xuce        , Xuce        , Qxe         , Xue         , Xue         , Uue         , Uue         , Xue         , Xu          , Xu          , Xu          , Rb          , Uu^Uf       , Uu          , Uu          , Uu          , Uu^Uf       , Uu          , Uu          , Uu          , Uu^Uf       , Uu          , Xue         , Uue         , Xue         , Qxe         , Xue         , Xue         , Xu          
Xu          , Xu          , Xu          , Xu          , Xu          , Xuce        , Xu          , Xue         , Xue         , Xu          , Uh          , Xu          , Cud         , Rb          , Rb          , Uu^Uf       , Uu          , Uu^Vu       , Uu          , Uu          , Uh          , Uu^Uf       , Uu          , Uu          , Xue         , Xue         , Uue^Uf      , Uue         , Uue^Uf      , Qxe         , Xue         , Xu          
Xu          , Xu          , Xu          , Xu          , Xu          , Xu          , Xu          , Xu          , Xu          , Uu          , Uu          , Uu          , Uh          , Cud         , Cud         , Rb          , Rb          , Uu          , Uh          , Uh          , Uu          , Uu^Uf       , Uh          , Uh          , Xue         , Qxe         , Qxe         , Uue         , Uue^Uf      , Qxe         , Xue         , Xu          
Xu          , Xu          , Xu          , Xu          , Xu          , Xu          , Xu          , Xu          , Uu^Uf       , Uh          , Uu^Uf       , Uu          , Uu          , Uu          , Uu          , Cud         , Rb          , Uu          , Uh          , Uu          , Uu^Vu       , Uu          , Xu          , Xu          , Xu          , Xue         , Qxe         , Uue         , Uue         , Xue         , Xue         , Xu          
Xu          , Xu          , Xu          , Xu          , Xu          , Xu          , Xu          , Xu          , Uu          , Uu^Vud      , Uu          , Uh          , Uu          , Uu^Vud      , Uu^Uf       , Cud         , Cud         , Rb          , Rb          , Uu          , Uu^Uf       , Uu          , Xu          , Xu          , Xue         , Xue         , Uue         , Uue         , Uue         , Qxe         , Xue         , Xu          
Xu          , Xu          , Xu          , Xu          , Xu          , Xu          , Uu          , Uu^Uf       , Cud         , Uh          , Uu          , Cud         , 1 Kud       , Cud         , Uu          , Uu^Uf       , Cud         , Rb          , Xu          , Xu          , Xue         , Xu          , Xue         , Xue         , Qxe         , Qxe         , Uue^Uf      , Uue^Uf      , Qxe         , Qxe         , Xue         , Xu          
Xu          , Xu          , Xu          , Xu          , Xu          , Xu          , Uu          , Uu^Vud      , Uh          , Uh          , Ur          , Ur          , Cud         , Uu          , Uu          , Uu^Vud      , Uu          , Cud         , Xue         , Xue         , Qxe         , Xue         , Qxe         , Xue         , Uue^Uf      , Uue         , Xue         , Uue^Uf      , Qxe         , Xue         , Xu          , Xu          
Xu          , Xu          , Xu          , Xu          , Uu          , Uu          , Ur          , Ur          , Ur          , Cud         , Uu          , Uu          , Uh          , Uu          , Uh          , Uu          , Uh          , Uu          , Xue         , Qxe         , Uue         , Qxe         , Uue         , Uue^Uf      , Uue         , Uue         , Xue         , Uue         , Qxe         , Xue         , Xu          , Xu          
Xu          , Xu          , Uu          , Cud         , Ur          , Uu          , Uu          , Uu^Uf       , Uu          , Uh          , Uu^Uf       , Cud         , Uu          , Uu^Uf       , Uu          , Uu          , Uu^Uf       , Xue         , Uue         , Uue         , Uue^Uf      , Uue         , Uue         , Uue^Uf      , Xue         , Qxe         , Uue^Uf      , Uue         , Xue         , Xue         , Xu          , Xu          
Xu          , Xu          , Uu          , Ur          , Cud         , Cud         , Uh          , Uu          , Uu^Uf       , Uh          , Uu          , Uu^Uf       , Xue         , Uh          , Xu          , Uu^Vud      , Xu          , Xue         , Qxe         , Uue^Uf      , Qxe         , Uue         , Qxe         , Qxe         , Xue         , Qxe         , Qxe         , Qxe         , Xue         , Xu          , Xu          , Xu          
Xu          , Xu          , Uu          , Ur          , Cud         , Xu          , Xu          , Xu          , Xu          , Xu          , Xu          , Xuce        , Rb          , Xue         , Xuce        , Xu          , Xu          , Xue         , Xue         , Qxe         , Xue         , Xue         , Xue         , Xue         , Xu          , Xue         , Xue         , Xue         , Xu          , Xu          , Xu          , Xu          
Xu          , Xu          , Cud         , Uu          , Uu          , Xu          , Xu          , Xu          , Xu          , Xu          , Xuce        , Xuce        , Uue         , Uue^Uf      , Xuce        , Xu          , Xu          , Xu          , Xu          , Xue         , Xu          , Xu          , Xu          , Xu          , Xu          , Xu          , Xu          , Xu          , Xu          , Xu          , Xu          , Xu          
Xu          , Xu          , Cud         , Uu          , Ur          , Uu          , Uu          , Xu          , Xu          , Xu          , Xuce        , Uue^Vud     , Uue         , Xuce        , Xu          , Xu          , Xu          , Xu          , Xu          , Xu          , Xu          , Xu          , Xu          , Xu          , Xu          , Xu          , Xu          , Xu          , Xu          , Xu          , Xu          , Xu          
Xu          , Xu          , Qxu         , Cud         , Uu          , Ur          , Uu          , Uu^Vu       , Qxu         , Xu          , Xuce        , Uue         , Xuce        , Xuce        , Xu          , Xu          , Xu          , Xu          , Xu          , Xu          , Xu          , Xu          , Xu          , Xu          , Xu          , Xu          , Xu          , Xu          , Xu          , Xu          , Xu          , Xu          
Xu          , Xu          , Xu          , Qxu         , Qxu         , Uu          , Ur          , Uu          , Uh          , Qxu         , Qxe^Bs/     , Uue         , Xuce        , Xu          , Xu          , Xu          , Xu          , Xu          , Xu          , Xu          , Xu          , Xu          , Xu          , Xu          , Xu          , Xu          , Xu          , Xu          , Xu          , Xu          , Xu          , Xu          
Xu          , Xu          , Xu          , Xu          , Xu          , Uu^Vu       , Uu          , Ur          , Uu          , Uh          , Qxu         , Qxe         , Xu          , Xu          , Xu          , Xu          , Xu          , Xu          , Xu          , Xu          , Xu          , Xu          , Xu          , Xu          , Xu          , Xu          , Xu          , Xu          , Xu          , Xu          , Xu          , Xu          
Xu          , Xu          , Xu          , Xu          , Xu          , Qxu         , Qxu         , Uu          , Ur          , Uh          , Qxu         , Qxu         , Qxu         , Xu          , Xu          , Xu          , Xu          , Xu          , Xu          , Xu          , Xu          , Xu          , Xu          , Xu          , Xu          , Xu          , Xu          , Xu          , Xu          , Xu          , Xu          , Xu          
Xu          , Xu          , Xu          , Xu          , Xu          , Xu          , Xu          , Uu          , Ur          , Uu          , Uh          , Qxu         , Qxu         , Xu          , Xu          , Xu          , Xu          , Xu          , Xu          , Xu          , Xu          , Xu          , Xu          , Xu          , Xu          , Xu          , Xu          , Xu          , Xu          , Xu          , Xu          , Xu          
Xu          , Xu          , Xu          , Xu          , Xu          , Xu          , Cud         , Uu          , Uu          , Uu          , Cud         , Qxu         , Qxu         , Xu          , Xu          , Xu          , Xu          , Xu          , Xu          , Xu          , Xu          , Xu          , Xu          , Xu          , Xu          , Xu          , Xu          , Xu          , Xu          , Xu          , Xu          , Xu          
Xu          , Xu          , Xu          , Xu          , Xu          , Xu          , Cud         , Cud         , Uu          , Cud         , Cud         , Qxu         , Qxu         , Xu          , Xu          , Xu          , Xu          , Xu          , Xu          , Xu          , Xu          , Xu          , Xu          , Xu          , Xu          , Xu          , Xu          , Xu          , Xu          , Xu          , Xu          , Xu          
Xu          , Xu          , Xu          , Xu          , Xu          , Xu          , Uu          , Uu          , Ur          , Uu          , Uu          , Qxu         , Xu          , Xu          , Xu          , Xu          , Xu          , Xu          , Xu          , Xu          , Xu          , Xu          , Xu          , Xu          , Xu          , Xu          , Xu          , Xu          , Xu          , Xu          , Xu          , Xu          
