Ur, Ur, Ur, Uu, Uu, Uu, Cud, Cud, Xos, Xos, Irs, Xos, Xos, Cud, Cud, Uu, Uu, Uu, Uu, Ur
Uu, Ur, Ur, Uu, Cud, Cud, Xos, Xos, Irs, Irs, Cud, Irs, Irs, Xos, Xos, Cud, Cud, Uu, Ur, Ur
Uu, Uu, Uu, Ur, 1 Irs, Xos, Irs, Irs, Irs, Cud, Cud, Cud, Irs, Irs, Irs, Xos, Irs, Ur, Ur, Uu
Uu, Uu, Uu, Cud, Xos, Irs, Cud, Irs, Cud, Irs, Irs, Irs, Cud, Irs, Cud, Irs, Xos, Cud, Uu, Uu
Uu, Uu, Uu, Cud, Xos, Irs, Irs, Cud, Irs, Irs, Cud, Irs, Irs, Cud, Irs, Irs, Xos, Cud, Uu, Uu
Uu, Uu, Uu, Cud, Xos, Irs, Irs, Cud, Irs, Cud, 2 Kud, Cud, Irs, Cud, Irs, Irs, Xos, Cud, Uu, Uu
Uu, Uu, Uu, Cud, Xos, Irs, Cud, Irs, Irs, Cud, Cud, Cud, Irs, Irs, Cud, Irs, Xos, Cud, Uu, Uu
Uu, Uu, Uu, Cud, Xos, Irs, Cud, Cud, Irs, Irs, Irs, Irs, Irs, Cud, Cud, Irs, Xos, Cud, Uu, Uu
Uu, Uu, Uu, Cud, Irs, Irs, Irs, Cud, Irs, Cud, Cud, Cud, Irs, Cud, Irs, Irs, Irs, Cud, Uu, Uu
Uu, Uu, Ur, Ur, Cud, Xos, Xos, Irs, Irs, Irs, Cud, Irs, Irs, Irs, Xos, Xos, Cud, Ur, Uu, Uu
Uu, Uu, Ur, Uu, Uu, Cud, Cud, Xos, Xos, Irs, Irs, Irs, Xos, Xos, Cud, Cud, Uu, Ur, Uu, Uu
Ur, Ur, Uu, Uu, Uu, Uu, Uu, Cud, Cud, Xos, Irs, Xos, Cud, Cud, Uu, Uu, Uu, Ur, Ur, Ur
