Ur, Ur, Ur, Uu, Uu, Uu, Cud, Cud, Xos, Xos, Isr, Xos, Xos, Cud, Cud, Uu, Uu, Uu, Uu, Ur
Uu, Ur, Ur, Uu, Cud, Cud, Xos, Xos, Isr, Isr, Cud, Isr, Isr, Xos, Xos, Cud, Cud, Uu, Ur, Ur
Uu, Uu, Uu, Ur, 1 Isr, Xos, Isr, Isr, Isr, Cud, Cud, Cud, Isr, Isr, Isr, Xos, Isr, Ur, Ur, Uu
Uu, Uu, Uu, Cud, Xos, Isr, Cud, Isr, Cud, Isr, Isr, Isr, Cud, Isr, Cud, Isr, Xos, Cud, Uu, Uu
Uu, Uu, Uu, Cud, Xos, Isr, Isr, Cud, Isr, Isr, Cud, Isr, Isr, Cud, Isr, Isr, Xos, Cud, Uu, Uu
Uu, Uu, Uu, Cud, Xos, Isr, Isr, Cud, Isr, Cud, 2 Kud, Cud, Isr, Cud, Isr, Isr, Xos, Cud, Uu, Uu
Uu, Uu, Uu, Cud, Xos, Isr, Cud, Isr, Isr, Cud, Cud, Cud, Isr, Isr, Cud, Isr, Xos, Cud, Uu, Uu
Uu, Uu, Uu, Cud, Xos, Isr, Cud, Cud, Isr, Isr, Isr, Isr, Isr, Cud, Cud, Isr, Xos, Cud, Uu, Uu
Uu, Uu, Uu, Cud, Isr, Isr, Isr, Cud, Isr, Cud, Cud, Cud, Isr, Cud, Isr, Isr, Isr, Cud, Uu, Uu
Uu, Uu, Ur, Ur, Cud, Xos, Xos, Isr, Isr, Isr, Cud, Isr, Isr, Isr, Xos, Xos, Cud, Ur, Uu, Uu
Uu, Uu, Ur, Uu, Uu, Cud, Cud, Xos, Xos, Isr, Isr, Isr, Xos, Xos, Cud, Cud, Uu, Ur, Uu, Uu
Ur, Ur, Uu, Uu, Uu, Uu, Uu, Cud, Cud, Xos, Isr, Xos, Cud, Cud, Uu, Uu, Uu, Ur, Ur, Ur
