Uu, Ur, Ur, Uu, Uu, Tb^Tf, Tb^Tf, Xu, Xu, Xu, Xu, Xu, Xu, Xu, Xu, Xu, Xu, Xu, Xu, Xu, Xu, Uu, Tb^Tf, Uu, Uu, Xu, Xu, Xu, Xu, Xu, Xu, Xu, Xu, Xu, Xu, Xu, Xu, Xu, Xu, Xu, Xu, Xu, Xu, Xu, Xu, Xu, Xu, Xu, Xu, Xu
Tb^Tf, Uu, Uu, Ur, Ur, Uu, Uh, Xu, Xu, Xu, Xu, Xu, Xu, Xu, Xu, Xu, Xu, Xu, Xu, Xu, Xu, Uh, Uu, Tb^Tf, Uh, Xu, Xu, Xu, Xu, Xu, Xu, Xu, Xu, Xu, Xu, Xu, Xu, Xu, Xu, Xu, Xu, Xu, Xu, Xu, Xu, Xu, Xu, Xu, Xu, Xu
Tb^Tf, Tb^Tf, Uu, Uh, Ur, Uu, Cud, Uh, Tb^Tf, Tb^Tf, Xu, Xu, Xu, Xu, Xu, Xu, Xu, Xu, Xu, Xu, Xu, Xu, Uh, Uu^Vu, Uh, Uu, Xu, Xu, Xu, Xu, Xu, Xu, Xu, Xu, Xu, Xu, Xu, Xu, Xu, Xu, Xu, Xu, Xu, Xu, Xu, Xu, Xu, Xu, Xu, Xu
Xu, Xu, Xu, Uh, Uh, Cud, 5 Kud, Cud, Uu, Tb^Tf, Xu, Xu, Xu, Xu, Xu, Xu, Xu, Xu, Xu, Xu, Xu, Uh, Uu, Tb^Tf, Tb^Tf, Uh, Xu, Xu, Xu, Xu, Xu, Xu, Xu, Xu, Xu, Xu, Xu, Xu, Xu, Xu, Xu, Xu, Xu, Xu, Xu, Xu, Uh, Uh, Tb^Tf, Xu
Xu, Xu, Xu, Uu, Uu, Cud, Cud, Cud, Ur, Uu, Uu, Xu, Xu, Xu, Xu, Xu, Xu, Xu, Xu, Xu, Xu, Xu, Uu, Tb^Tf, Co, Co, Co, Xu, Xu, Xu, Xu, Xu, Xu, Xu, Xu, Xu, Xu, Xu, Xu, Xu, Xu, Xu, Xu, Xu, Tb^Tf, Uu, Ur, Uu^Vu, Ur, Tb^Tf
Xu, Xu, Xu, Uh, Uh, Uu, Uh, Tb^Tf, Ur, Uu, Tb^Tf, Xu, Xu, Xu, Xu, Xu, Xu, Xu, Xu, Xu, Xu, Xu, Xu, Uu, Ko, Co, Co, Uu, Xu, Xu, Xu, Xu, Xu, Xu, Xu, Xu, Xu, Xu, Xu, Xu, Tb^Tf, Uh, Uh, Uh, Ur, Ur, Uu, Ur, Uh, Ur
Xu, Xu, Xu, Xu, Xu, Uu, Uh, Tb^Tf, Ur, Tb^Tf, Uh, Uu, Uu, Xu, Xu, Xu, Xu, Xu, Xu, Xu, Xu, Xu, Xu, Tb^Tf, Tb^Tf, Co, Uu, Uh, Xu, Xu, Xu, Xu, Xu, Xu, Xu, Xu, Xu, Xu, Xu, Uh, Tb^Tf, Tb^Tf, Uh, Uh, Ur, Tb^Tf, Uu, Uh, Uu, Uu
Xu, Xu, Xu, Xu, Xu, Uu, Uu^Vu, Uh, Ur, Tb^Tf, Uh, Tb^Tf, Tb^Tf, Uu, Uh, Xu, Xu, Xu, Xu, Xu, Xu, Xu, Xu, Uu, Uu, Uh, Uu^Vu, Uh, Uh, Xu, Xu, Xu, Xu, Xu, Xu, Xu, Xu, Xu, Uh, Uh, Uu^Vu, Tb^Tf, Ur, Ur, Uu, Tb^Tf, Xuc, Uu, Xuc, Xuc
Xu, Xu, Xu, Xu, Uh, Uu, Tb^Tf, Tb^Tf, Uu, Ur, Ur, Uu, Uu, Uu^Vu, Uu, Xu, Xu, Xu, Xu, Xu, Xu, Xu, Xu, Uh, Uu, Uu, Uh, Uu, Uu, Xu, Xu, Xu, Xu, Xu, Xu, Xu, Xu, Xu, Uu, Uu, Cud, Cud, Cud, Tb^Tf, Xuc, Xuc, Xuc, Xuc, Xuc, Xuc
Xu, Xu, Xu, Xu, Uh, Uu, Tb^Tf, Uh, Ur, Ur, Uu, Ur, Ur, Uh, Tb^Tf, Xu, Xu, Xu, Xu, Xu, Xu, Xu, Xu, Uh, Uh, Uu, Uh, Uu, Uu, Xu, Xu, Xu, Xu, Xu, Xu, Xu, Xu, Xu, Uu, Tb^Tf, Cud, 6 Kud, Cud, Tb^Tf, Xuc, Xuc, Xuc, Xuc, Xuc, Xuc
Xu, Xu, Xu, Xu, Xu, Uu, Ur, Ur, Tb^Tf, Uh, Xuc, Uu, Xuc, Ur, Ur, Uu, Uh, Xu, Xu, Xu, Xu, Xu, Xu, Xu, Uu, Uu, Uu, Tb^Tf, Uu, Uh, Xu, Xu, Xu, Xu, Xu, Xu, Xu, Uh, Tb^Tf, Uu, Ur, Cud, Uh, Uu, Xuc, Xuc, Xuc, Xuc, Xu, Xu
Xu, Xu, Xu, Xu, Xu, Ur, Uu, Uu, Uu, Xuc, Xuc, Xuc, Xuc, Xuc, Xuc, Ur, Uu, Uh, Xu, Xu, Xu, Xu, Xu, Xu, Uh, Uu^Vu, Tb^Tf, Tb^Tf, Uu, Uh, Uh, Xu, Xu, Xu, Xu, Xu, Uh, Uh, Tb^Tf, Tb^Tf, Ur, Uh, Uh, Uu, Xuc, Xuc, Xu, Xu, Rb^Vu, Uue
Xu, Xu, Xu, Xu, Xu, Ur, Tb^Tf, Uu, Uh, Uh, Xuc, Xuc, Xuc, Xuc, Uu, Ur, Uu, Uh, Xu, Xu, Xu, Xu, Xu, Xu, Uh, Uu, Uu, Uh, Uh, Uu^Vu, Uu, Xu, Xu, Xu, Xu, Xu, Uu, Tb^Tf, Uu, Uu^Vu, Ur, Uu, Xu, Xu, Xu, Xuc, Xu, Rb, Uue, Rb
Xu, Xu, Xu, Xu, Xu, Ur, Ur, Uh, Xuc, Xuc, Xuc, Xuc, Xuc, Uu, Uu^Vu, Ur, Tb^Tf, Uu, Tb^Tf, Xu, Xu, Xu, Xu, Xu, Xu, Uh, Uu, Uh, Uu, Tb^Tf, Xu, Xu, Xu, Xu, Uh, Uu, Uh, Uh, Uu, Ur, Xu, Xu, Xu, Xu, Uue, Xu, Rb^Vu, Uue, Uue, Uue
Xu, Xu, Xu, Xu, Xu, Xu, Ur, Uu^Vu, Xuc, Xuc, Xuc, Xuc, Xuc, Xuc, Uh, Ur, Ur, Tb^Tf, Uh, Uu, Uu, Xu, Xu, Xu, Xu, Xu, Xu, Xu, Xu, Xu, Xu, Xu, Xu, Xu, Uh, Uu, Uu, Uh, Ur, Ur, Uu, Xu, Tb^Tf, Tb^Tf, Co, Uue, Uue, Rb, Xu, Xu
Xu, Xu, Xu, Xu, Xu, Xu, Uh, Ur, Ur, Xuc, Uu, Uu, Uu, Uh, Tb^Tf, Uu, Ur, Uh, Uh, Uu, Uu, Uu, Uu, Xu, Tb^Tf, Uu, Uh, Uu, Uu, Xu, Uu, Uu, Uu, Uh, Uu, Uu^Vu, Uu, Uu, Ur, Uu, Tb^Tf, Xu, Xu, Co, Ko, Co, Tb^Tf, Tb^Tf, Xu, Xuc
Xu, Xu, Xu, Xu, Xu, Xu, Uu, Uh, Tb^Tf, Ur, Ur, Ur, Ur, Tb^Tf, Uh, Tb^Tf, Ur, Uu, Uu, Uu, Tb^Tf, Uu, Uu, Uu, Tb^Tf, Uh, Uh, Uu, Uu, Tb^Tf, Uu, Uu, Uu, Uu, Tb^Tf, Uu, Uh, Uh, Ur, Uu, Tb^Tf, Tb^Tf, Xu, Co, Co, Co, Tb^Tf, Xu, Xuc, Xuc
Xu, Xu, Xu, Xu, Xu, Xu, Xu, Uu, Tb^Tf, Tb^Tf, Uh, Uu, Tb^Tf, Ur, Ur, Ur, Ur, Uu, Uu, Tb^Tf, Uh, Tb^Tf, Xu, Uu, Uh, Tb^Tf, Uu, Uu, Tb^Tf, Tb^Tf, Uh, Uh, Uh, Uu, Tb^Tf, Uu, Uu, Uh, Ur, Tb^Tf, Uu, Xu, Uue, Rb^Vu, Rb, Uue, Xu, Xu, Xuc, Xuc
Xu, Xu, Xu, Xu, Xu, Xu, Xu, Xu, Xu, Uh, Xu, Uh, Tb^Tf, Uu, Uu, Uh, Uu, Ur, Ur, Uh, Xu, Xu, Xu, Xu, Xu, Uh, Uu, Uu, Uu, Uh, Xu, Xu, Xu, Uu, Uu, Tb^Tf, Uu, Ur, Uu, Uu^Vu, Uu, Xu, Xu, Uue, Xuc, Xu, Xuc, Xuc, Xuc, Xuc
Xu, Xu, Xu, Xu, Xu, Xu, Xu, Xu, Xu, Xu, Xu, Xu, Xu, Tb^Tf, Uu, Uu, Uh, Uu, Ur, Uh, Cud, Xu, Xuc, Xuc, Xuc, Xu, Cud, Uu, Cud, Xu, Xuc, Xuc, Xuc, Xu, Xu, Uu, Uu, Ur, Uu, Uu, Uh, Xu, Xuc, Xuc, Xuc, Xuc, Xuc, Xuc, Xuc, Xuc
Xu, Xu, Xu, Xu, Xu, Xu, Xu, Xu, Xu, Xu, Xu, Xu, Xu, Xu, Tb^Tf, Uh, Xu, Xu, Cud, Rrc, Rrc, Xuc, Cud, Kud, Cud, Xuc, Rrc, Rrc, Uu, Xuc, Cud, Cud, Cud, Xuc, Xu, Uh, Uu, Ur, Tb^Tf, Uh, Xuc, Xuc, Xuc, Xuc, Xuc, Xuc, Xuc, Xuc, Xuc, Xuc
Xu, Xu, Xu, Xu, Xu, Xu, Xu, Xu, Xu, Xu, Uu^Vu, Xu, Xu, Xu, Uu, Tb^Tf, Xu, Xu, Xu, Uu, Uu, Rrc, Uu, Cud, Uu^Vud, Rrc, Uu^Vud, Uu, Uu^Vud, Uu, Rrc, Kud, Cud, Xuc, Cud, Uh, Ur, Ur, Tb^Tf, Xuc, Xuc, Xuc, Xuc, Xuc, Xuc, Xuc, Xuc, Xuc, Xuc, Xuc
Xu, Xu, Xu, Xu, Xu, Xu, Uu, Uh, Uh, Uu, Uu, Xu, Xu, Uu, Uu, Tb^Tf, Xu, Xu, Xu, Uu^Vud, Rrc, Rrc, Rrc, Uu, Rrc, Rrc, Rrc, Uu, Rrc, Rrc, Uu^Vud, Rrc, Rrc, Rrc, Rrc, Ur, Uu, Uu, Uh, Xuc, Xuc, Xuc, Xuc, Xuc, Xuc, Xuc, Xuc, Xuc, Xuc, Xuc
Xu, Xu, Xu, Xu, Uu, Tb^Tf, Tb^Tf, Uu^Vu, Tb^Tf, Tb^Tf, Uu, Xu, Xu, Uu, Uu, Uu, Xu, Xu, Rrc, Rrc, Uu, Uu^Vud, Uu, Rrc, 1 Cud, 3 Cud, 4 Cud, Rrc, Uu^Vud, Uu, Uu, Uu, Uu, Uu, Cud, Xuc, Xu, Uu, Uu, Uh, Xuc, Xuc, Xuc, Xuc, Xuc, Xuc, Xuc, Xuc, Xuc, Xuc
Xu, Xu, Xu, Xu, Uh, Uu, Uh, Uu, Uu, Tb^Tf, Uh, Uu^Vu, Xu, Xu, Uh, Uu, Uu, Rrc, Cud, Uu, Uu^Vud, Uu, Uu, Rrc, Cud, 2 Kud, Cud, Rrc, Uu, Uu, Uu, Uu^Vud, Rrc, Cud, Xuc, Xuc, Uh, Uu, Uu, Xuc, Xuc, Xuc, Uh, Xuc, Xuc, Xuc, Xuc, Xuc, Xuc, Xuc
Xu, Xu, Tb^Tf, Uu, Co, Co, Xu, Uh, Xu, Xu, Xu, Xu, Xu, Xu, Uu, Uu, Uu, Cud, Xuc, Xuc, Uu, Uu, Rrc, Rrc, Rrc, Cud, Rrc, Rrc, Rrc, Uu^Vud, Rrc, Rrc, Uu, Rrc, Ur, Xu, Tb^Tf, Tb^Tf, Uu, Xuc, Tb^Tf, Uh, Ur, Uh, Cud, Xuc, Xuc, Xuc, Xuc, Xuc
Xu, Uu, Tb^Tf, Tb^Tf, Ko, Co, Xu, Xu, Xu, Xu, Xu, Xu, Xu, Xu, Uh, Uu, Uu, Xuc, Cud, Cud, Rrc, Rrc, Uu^Vud, Uu, Uu^Vud, Rrc, Uu, Uu^Vud, Uu, Rrc, Uu^Vud, Uu, Xu, Cud, Uh, Ur, Ur, Tb^Tf, Uu, Tb^Tf, Ur, Ur, Tb^Tf, Ur, Ur, Cud, 7 Kud, Cud, Uu^Vu, Uu
Uu, Uu^Vu, Uu, Co, Co, Co, Xu, Xu, Xu, Xu, Xu, Xu, Xu, Xu, Uh, Uu, Uu, Uu, Ur, Rrc, Cud, Uu, Uu, Uu, Rrc, Rrc, Xu, Uu, Uu^Vud, Uu, Xu, Xu, Xu, Xu, Uh, Uh, Uu, Ur, Ur, Ur, Uu, Tb^Tf, Uu, Uu, Tb^Tf, Cud, Cud, Tb^Tf, Ur, Uu
Uh, Uh, Uh, Uu, Xu, Xu, Xu, Xu, Xu, Xu, Xu, Xu, Xu, Uh, Tb^Tf, Uu, Ur, Ur, Xu, Xuc, Cud, Kud, Cud, Uu^Vud, Rrc, Cud, Xu, Xu, Xu, Xu, Xu, Xu, Xu, Xu, Uu, Uu, Uu, Uu, Uu, Uu^Vu, Uu, Uu, Tb^Tf, Uu^Vu, Uu, Tb^Tf, Uh, Cud, Uh, Ur
Uh, Uh, Xu, Xu, Xu, Xu, Xu, Xu, Xu, Xu, Xu, Xu, Uu, Tb^Tf, Ur, Ur, Uu, Uu, Xu, Xuc, Xuc, Cud, Xuc, Xuc, Rrc, Cud, Xu, Xu, Xu, Xu, Xu, Xu, Uh, Tb^Tf, Uu, Uu, Uh, Uh, Uh, Uu, Tb^Tf, Tb^Tf, Uh, Uh, Xu, Tb^Tf, Xu, Uh, Tb^Tf, Uu
Xu, Xu, Xu, Xu, Xu, Xu, Xu, Xu, Xu, Xu, Xu, Uh, Uu, Ur, Uu, Tb^Tf, Uu, Uu, Uu, Xu, Xu, Xu, Xu, Xu, Uu, Uh, Uh, Xu, Xu, Xu, Uh, Uh, Tb^Tf, Tb^Tf, Uu, Uh, Xu, Xu, Xu, Xu, Xu, Uh, Xu, Xu, Xu, Xu, Xu, Xu, Xu, Tb^Tf
Xu, Xu, Xu, Xu, Xu, Xu, Xu, Xu, Xu, Xu, Uh, Uh, Uu, Ur, Tb^Tf, Tb^Tf, Uh, Uu, Uu, Uu, Uu, Xu, Uu, Uh, Uh, Uu, Uh, Tb^Tf, Uu, Uu, Uu, Uu, Uu, Uu, Uh, Uh, Xu, Xu, Xu, Xu, Xu, Xu, Xu, Xu, Xu, Xu, Xu, Xu, Xu, Xu
Xu, Xu, Xu, Xu, Xu, Xu, Xu, Xu, Xu, Xu, Tb^Tf, Tb^Tf, Uu, Ur, Uu, Uh, Xu, Xu, Xu, Uu, Uu, Uu, Uu, Uu, Uu, Uu, Uu, Tb^Tf, Tb^Tf, Uh, Uh, Tb^Tf, Tb^Tf, Tb^Tf, Xu, Xu, Xu, Xu, Xu, Xu, Xu, Xu, Xu, Xu, Xu, Xu, Xu, Xu, Xu, Xu
Xu, Xu, Xu, Xu, Xu, Xu, Xu, Xu, Xu, Uh, Uh, Tb^Tf, Ur, Ur, Uh, Uh, Xu, Xu, Xu, Xu, Uh, Uu, Uh, Tb^Tf, Tb^Tf, Uu, Uu, Uu, Xu, Uu, Xu, Uu, Xu, Xu, Xu, Xu, Xu, Xu, Xu, Xu, Xu, Xu, Xu, Xu, Xu, Xu, Xu, Xu, Xu, Xu
Xu, Xu, Xu, Xu, Xu, Xu, Xu, Xu, Uu, Uh, Uu, Uu, Ur, Uu^Vu, Uh, Xu, Xu, Xu, Xu, Xu, Xu, Uh, Xu, Xu, Xu, Uu, Xu, Xu, Tb^Tf, Xu, Uu, Xu, Xu, Xu, Xu, Xu, Xu, Xu, Xu, Xu, Xu, Xu, Xu, Xu, Xu, Xu, Xu, Xu, Xu, Xu
Xu, Xu, Xu, Xu, Xu, Xu, Uh, Uh, Uu, Uu^Vu, Ur, Ur, Uu, Uh, Xu, Xu, Xu, Xu, Xu, Xu, Xu, Xu, Xu, Xu, Xu, Xu, Uh, Uu, Tb^Tf, Uu, Uu, Uh, Xu, Xu, Xu, Xu, Xu, Xu, Xu, Xu, Xu, Xu, Xu, Xu, Xu, Xu, Xu, Xu, Xu, Xu
Xu, Xu, Xu, Xu, Xu, Uu, Uh, Uh, Ur, Ur, Uu, Tb^Tf, Uh, Uh, Xu, Xu, Xu, Xu, Xu, Xu, Xu, Xu, Xu, Xu, Xu, Xu, Uh, Tb^Tf, Uu, Uu^Vu, Uu, Uh, Uh, Xu, Xu, Xu, Xu, Xu, Xu, Xu, Xu, Xu, Xu, Xu, Xu, Xu, Xu, Xu, Xu, Xu
Xu, Xu, Xu, Xu, Uu, Uu, Ur, Ur, Uh, Uu, Tb^Tf, Tb^Tf, Xu, Xu, Xu, Xu, Xu, Xu, Xu, Xu, Xu, Xu, Xu, Xu, Xu, Xu, Xu, Uh, Uu, Uh, Uu, Tb^Tf, Uu, Xu, Xu, Xu, Xu, Xu, Xu, Xu, Xu, Xu, Xu, Xu, Xu, Xu, Xu, Xu, Xu, Xu
Xu, Xu, Uu, Uu, Ur, Ur, Uh, Uh, Uh, Uh, Xu, Xu, Xu, Xu, Xu, Xu, Xu, Xu, Xu, Xu, Xu, Xu, Xu, Xu, Xu, Xu, Xu, Uu, Uu, Uu, Tb^Tf, Tb^Tf, Uh, Xu, Xu, Xu, Xu, Xu, Xu, Xu, Xu, Xu, Xu, Xu, Xu, Xu, Xu, Xu, Xu, Xu
Xu, Xu, Uu, Tb^Tf, Ur, Uu^Vu, Uh, Uh, Xu, Xu, Xu, Xu, Xu, Xu, Xu, Xu, Xu, Xu, Xu, Xu, Xu, Xu, Xu, Xu, Xu, Xu, Xu, Uh, Uh, Uu^Vu, Co, Uh, Uh, Xu, Xu, Xu, Xu, Xu, Xu, Xu, Xu, Xu, Xu, Xu, Xu, Xu, Xu, Xu, Xu, Xu
Xu, Uh, Uu, Tb^Tf, Ur, Uu, Uu, Xu, Xu, Xu, Xu, Xu, Xu, Xu, Xu, Xu, Xu, Xu, Xu, Xu, Xu, Xu, Xu, Xu, Xu, Xu, Xu, Xu, Tb^Tf, Uu, Co, Co, Uu^Vu, Uu, Tb^Tf, Xu, Xu, Xu, Xu, Xu, Xu, Xu, Xu, Xu, Xu, Xu, Xu, Xu, Xu, Xu
Uh, Uh, Cud, Cud, Cud, Uu, Xu, Xu, Xu, Xu, Xu, Xu, Xu, Xu, Xu, Xu, Xu, Xu, Xu, Xu, Xu, Xu, Xu, Xu, Xu, Xu, Xu, Xu, Xu, Tb^Tf, Uh, 9 Ko, Co, Uh, Tb^Tf, Xu, Xu, Xu, Xu, Xu, Xu, Xu, Xu, Xu, Xu, Xu, Xu, Xu, Xu, Xu
Uu, Uu, Cud, 8 Kud, Cud, Uu, Xu, Xu, Xu, Xu, Xu, Xu, Xu, Xu, Xu, Xu, Xu, Xu, Xu, Xu, Xu, Xu, Xu, Xu, Xu, Xu, Xu, Xu, Xu, Tb^Tf, Uh, Uh, Co, Co, Tb^Tf, Tb^Tf, Uu, Xu, Xu, Xu, Xu, Xu, Xu, Xu, Xu, Xu, Xu, Xu, Xu, Xu
Ur, Ur, Uu, Cud, Xu, Xu, Xu, Xu, Xu, Xu, Xu, Xu, Xu, Xu, Xu, Xu, Xu, Xu, Xu, Xu, Xu, Xu, Xu, Xu, Xu, Xu, Xu, Xu, Xu, Xu, Xu, Uh, Uu, Uu, Uh, Uu, Uu^Vu, Uu, Xu, Xu, Xu, Xu, Xu, Xu, Xu, Xu, Xu, Xu, Xu, Xu
Tb^Tf, Tb^Tf, Uu, Uh, Xu, Xu, Xu, Xu, Xu, Xu, Xu, Xu, Xu, Xu, Xu, Xu, Xu, Xu, Xu, Xu, Xu, Xu, Xu, Xu, Xu, Xu, Xu, Xu, Xu, Xu, Xu, Xu, Xu, Uu, Uu, Uu, Uh, Tb^Tf, Tb^Tf, Xu, Xu, Xu, Xu, Xu, Xu, Xu, Xu, Xu, Xu, Xu
Tb^Tf, Tb^Tf, Xu, Xu, Xu, Xu, Xu, Xu, Xu, Xu, Xu, Xu, Xu, Xu, Xu, Xu, Xu, Xu, Xu, Xu, Xu, Xu, Xu, Xu, Xu, Xu, Xu, Xu, Xu, Xu, Xu, Xu, Xu, Uu, Uh, Uh, Uh, Tb^Tf, Tb^Tf, Xu, Xu, Xu, Xu, Xu, Xu, Xu, Xu, Xu, Xu, Xu
